BL KB BL WL BL BL BL
CH ST BL DB BL BL BL
BL BL BL WL BL KY BL
WL DY WL WL WL WL WL
BL BL BL WL BL BL BL
BL BL BL DP BL PL BL
BL BL BL WL BL BL BL