WL WL WL WL WL WL WL WL WL BL BL BL BL BL BL BL BL BL BL BL BL BL
WL WL BL BL BL BL BL CH WL WL WL WL WL WL WL WL WL WL WL WL WL WL
WL CH BL WL BL WL WL WL WL WL BL BL BL BL BL WL BL BL BL BL BL WL
WL WL BL BL BL BL BL WL WL WL DP WL WL PL BL WL BL BL WL BL CH WL
WL WL WL WL WL WL BL CH WL BL BL BL WL WL WL WL BL BL WL WL WL WL
WL WL BL BL BL BL BL WL WL BL ST BL WL BL BL BL BL BL WL BL BL WL
WL CH BL WL BL WL WL WL WL BL BL BL WL BL BL WL BL BL BL BL CH WL
WL WL BL BL BL BL BL BL BL BL BL BL BL BL BL WL WL WL WL WL WL WL
WL WL WL WL WL WL WL WL WL WL WL BL WL BL BL WL BL BL BL BL CH WL
BL BL BL BL WL BL BL BL BL BL BL BL WL BL BL BL BL BL WL BL BL WL
BL BL BL BL WL BL CH BL CH BL WL WL WL WL WL WL BL BL WL WL WL WL
BL BL BL BL WL BL BL WL BL BL WL BL BL BL BL WL BL BL WL BL CH WL
BL BL BL BL WL BL CH BL CH BL WL BL BL BL BL WL BL BL BL BL BL WL
BL BL BL BL WL BL BL BL BL BL WL BL BL BL BL WL WL WL WL WL WL WL
BL BL BL BL WL WL WL WL WL WL WL BL BL BL BL BL BL BL BL BL BL BL