BL BL BL BL BL BL BL WL WL WL BL BL BL BL BL BL
BL BL BL BL BL BL BL WL PL WL BL BL BL BL BL BL
BL BL BL WL WL WL WL WL DP WL WL WL WL BL BL BL
BL BL BL WL BL BL BL BL BL BL BL BL WL BL BL BL
BL BL BL WL BL WL WL WL WL WL WL BL WL BL BL BL
WL WL WL WL BL WL BL BL BL BL WL BL WL WL WL WL
WL BL BL BL BL WL BL BL CH BL WL BL BL BL BL WL
WL BL WL WL WL WL BL BL BL BL WL WL WL WL BL WL
WL BL WL BL BL BL BL BL BL BL BL BL BL WL BL WL
WL BL WL BL BL WL BL BL BL BL WL BL BL WL BL WL
WL BL WL BL CH WL BL ST BL BL WL CH BL WL BL WL
WL BL WL BL BL BL BL BL BL BL BL BL BL WL BL WL
WL BL WL WL WL WL BL BL BL BL WL WL WL WL BL WL
WL BL BL BL BL BL BL BL BL BL BL BL BL BL BL WL
WL WL WL WL WL WL BL CH BL BL WL WL WL WL WL WL
BL BL BL BL BL WL WL WL WL WL WL BL BL BL BL BL